4 4 4 4 4 4 4 4 4 4 4 4 4 4 4 4 4 4 4 4 4 4 4 4 4 4 4 4 4 4 4 4 4 4 4 4 4 4 4 4 4 4 4 4 4 4 4 4 4 4 4 4 4 4 4 4 4 4 4 4 4 4 4 4
4 0 0 0 0 0 0 0 0 0 0 0 0 0 0 0 0 0 0 0 0 0 0 0 0 0 4 4 0 0 0 0 0 0 0 0 0 0 1 0 0 5 0 0 0 1 0 0 1 0 0 0 0 0 0 0 0 0 0 0 0 0 0 4
4 0 0 0 0 0 0 0 0 0 0 0 0 0 0 0 0 0 0 0 0 0 0 0 0 0 4 4 0 0 0 0 0 0 0 0 0 0 1 0 0 5 0 0 0 1 0 0 1 0 0 0 0 0 0 8 0 0 0 0 0 0 0 4
4 0 0 0 0 0 0 0 0 0 0 0 0 0 0 0 0 0 0 0 0 0 0 0 0 0 4 4 0 0 8 0 0 0 0 1 0 0 1 0 0 5 0 0 0 1 0 0 1 0 0 0 0 4 4 4 4 4 5 5 5 0 0 4
4 0 0 0 0 0 0 0 0 0 0 0 0 0 0 0 0 0 0 0 0 0 0 0 0 0 4 4 5 5 4 1 1 4 0 1 0 0 1 0 0 5 0 0 0 1 0 8 1 0 0 0 9 4 4 4 4 4 0 0 5 0 0 4
4 0 0 0 0 0 0 0 0 0 0 0 0 0 0 0 0 0 0 0 0 0 0 0 0 0 4 4 0 0 5 0 0 4 0 1 8 0 5 0 0 5 8 0 0 5 0 0 1 0 0 9 4 4 4 4 4 4 0 0 5 0 0 4
4 0 0 0 0 0 0 0 0 0 0 0 0 0 0 0 0 0 0 0 0 0 0 0 0 0 4 4 0 0 5 0 0 4 0 1 0 0 5 8 0 5 0 0 0 5 0 0 1 0 0 0 0 9 4 0 0 1 0 0 5 0 0 4
4 0 0 0 0 0 0 0 0 0 0 0 0 0 0 0 0 0 0 0 0 0 0 0 0 0 4 4 1 1 4 1 1 4 9 0 0 0 5 0 0 0 0 0 0 5 0 0 1 0 0 8 0 9 4 0 0 1 0 0 5 4 4 4
4 0 0 0 0 0 0 0 0 0 0 0 0 0 0 0 0 0 0 0 0 0 0 0 0 0 4 9 0 0 5 0 0 4 9 0 0 0 0 0 0 0 0 0 0 5 0 0 1 0 0 5 5 9 4 8 0 1 0 0 5 4 4 4
4 0 0 0 0 0 0 0 0 0 0 0 0 0 0 0 0 0 0 0 0 0 0 0 0 0 4 9 0 0 5 0 0 4 9 0 0 0 0 0 0 0 0 0 0 0 0 0 1 0 0 0 0 9 4 0 0 1 0 0 0 4 4 4
4 0 0 0 0 0 0 0 0 0 0 0 0 0 0 0 0 0 0 0 0 0 0 0 0 0 4 4 1 1 4 5 5 4 9 9 9 9 9 9 9 9 9 9 9 9 9 9 9 9 9 9 9 9 4 0 0 1 0 0 0 0 4 4
4 0 0 0 0 0 0 0 0 0 0 0 0 0 0 0 0 0 0 0 0 0 0 0 0 0 4 4 0 0 3 0 0 4 4 4 4 4 4 4 4 4 4 4 4 4 4 4 4 4 4 4 4 4 4 4 4 4 4 4 0 0 0 4
4 0 0 4 4 4 4 4 4 4 4 4 4 4 4 4 4 4 4 4 4 4 4 4 4 4 4 4 0 0 3 0 0 4 9 0 0 0 0 0 0 0 1 4 4 4 4 4 4 4 4 4 4 4 4 4 4 4 4 4 4 0 0 4
4 1 1 4 4 4 4 9 9 4 4 4 4 9 9 4 4 4 4 4 4 4 9 9 4 4 4 4 5 5 4 1 1 4 9 0 0 0 0 0 0 0 1 0 4 4 4 4 4 4 4 4 4 4 4 4 4 4 4 4 0 0 0 4
4 0 0 1 0 0 7 0 0 4 0 0 1 0 0 3 0 0 4 0 0 3 0 0 4 0 0 5 0 0 7 0 0 9 9 0 0 0 0 0 0 0 1 0 0 0 0 0 0 0 0 0 0 0 4 4 4 4 4 0 0 0 4 4
4 0 0 1 8 0 7 0 0 4 0 0 1 0 0 3 0 0 4 0 0 3 8 0 4 0 0 5 0 0 7 8 0 9 9 0 0 0 0 1 1 0 1 0 0 0 0 0 0 0 0 0 0 0 0 0 0 0 0 0 0 4 4 4
4 5 5 4 3 3 4 5 5 4 1 1 4 7 7 4 5 5 4 1 1 4 5 5 4 3 3 4 4 4 4 3 3 4 9 0 0 0 0 0 0 0 1 0 0 0 0 0 0 0 0 0 0 0 0 0 8 0 0 0 4 4 4 4
4 0 0 4 0 0 7 0 0 3 0 0 5 0 0 1 0 0 5 0 0 1 0 0 1 0 0 5 0 0 1 0 0 4 9 0 5 5 0 0 0 0 0 0 0 0 0 0 5 5 0 0 0 4 4 4 4 4 4 4 4 4 4 4
4 8 0 4 0 0 7 8 0 3 0 0 5 0 0 1 0 0 5 0 0 1 0 0 1 0 0 5 0 0 1 0 0 4 9 0 0 0 0 0 0 0 0 0 1 1 0 0 0 0 0 0 0 4 4 4 4 0 0 0 0 0 0 4
4 7 7 4 5 5 4 4 4 4 4 4 4 1 1 4 1 1 4 3 3 4 7 7 4 5 5 4 1 1 4 5 5 4 9 0 0 0 0 1 1 0 0 0 0 0 0 0 0 0 0 0 0 4 4 4 0 0 0 8 0 0 0 4
9 0 0 1 0 0 4 0 0 1 0 0 3 0 0 4 0 0 5 0 0 1 0 0 5 0 0 5 0 0 7 0 0 9 9 0 0 0 0 0 0 0 0 0 0 0 0 0 0 0 0 0 0 0 0 0 0 0 4 4 4 0 0 4
9 0 0 1 0 0 4 0 0 1 0 0 3 8 0 4 0 0 5 0 0 1 0 0 5 0 0 5 8 0 7 0 0 9 9 0 5 5 0 0 0 0 0 0 0 0 0 0 0 0 0 0 0 0 0 0 0 4 4 4 4 5 5 4
4 3 3 4 3 3 4 5 5 4 5 5 4 1 1 4 4 4 4 1 1 0 1 1 4 4 4 4 5 5 4 1 1 4 9 0 0 0 0 0 0 0 0 0 5 5 0 0 1 1 0 0 4 4 4 4 4 4 4 4 4 0 0 4
4 0 0 5 0 0 7 0 0 4 0 0 5 0 0 5 0 0 0 0 0 5 0 0 7 0 0 5 0 0 3 0 0 4 9 0 0 0 0 1 1 0 0 0 0 0 0 0 0 0 0 0 4 4 4 4 4 4 4 4 4 0 0 4
4 0 0 5 8 0 7 0 0 4 8 0 5 0 0 5 0 0 0 8 0 5 0 0 7 0 0 5 0 0 3 8 0 4 9 9 9 9 9 9 9 9 9 9 9 9 9 9 9 9 9 9 4 4 4 4 4 4 4 4 4 0 0 4
4 9 9 4 4 4 4 9 9 4 4 4 4 4 4 4 9 9 4 4 4 4 9 9 4 4 4 4 4 4 4 4 4 4 4 4 4 4 4 4 4 4 4 4 4 4 4 4 4 4 4 4 4 4 4 4 4 4 4 4 4 0 0 4
4 4 4 4 4 4 4 4 4 4 4 4 4 4 4 4 4 4 4 4 4 4 4 4 4 4 4 4 4 4 4 4 4 4 4 4 4 4 4 4 4 4 4 4 4 4 4 4 4 4 4 4 4 4 4 4 4 4 4 4 4 1 1 4
4 4 4 4 4 4 4 4 4 4 4 4 4 4 4 4 4 4 4 4 4 4 4 4 0 0 0 0 0 0 0 0 0 0 0 0 0 0 0 0 0 0 0 0 0 0 0 0 7 5 0 0 0 3 1 0 0 0 7 5 0 0 0 4
4 4 4 4 4 4 4 4 4 4 4 4 4 4 4 4 4 4 4 4 4 4 4 0 0 0 8 0 0 0 0 0 0 0 0 0 0 0 0 0 0 0 0 0 0 8 0 0 7 5 0 0 0 3 1 0 0 0 7 5 0 0 0 4
4 0 0 0 0 0 0 0 5 0 0 0 1 0 0 0 5 0 0 0 1 0 0 0 0 4 4 4 5 5 5 4 4 4 1 1 1 4 4 4 5 5 5 4 4 4 4 4 4 4 4 4 4 4 4 4 4 4 4 4 4 4 4 4
4 0 0 0 0 8 0 0 5 0 0 0 1 0 0 0 5 0 0 0 1 0 0 0 4 4 4 4 9 9 9 4 4 4 9 9 9 4 4 4 9 9 9 4 4 4 4 4 4 4 4 4 4 4 4 4 4 4 4 4 4 4 4 4
4 4 4 4 4 4 4 4 4 4 4 4 4 4 4 4 4 4 4 4 4 4 4 4 4 4 4 4 4 4 4 4 4 4 4 4 4 4 4 4 4 4 4 4 4 4 4 4 4 4 4 4 4 4 4 4 4 4 4 4 4 4 4 4